┌───────┬─────┬───────────┬─────┬───┬───────┬─────────────┬─────┬─────┬─────────┬───┬─────────┬─┐
├─────┐ ╵ ┌─╴ │ ┌───┐ ┌─┐ │ ╶─┐ ╵ ╷ ╵ ╷ ╶─┐ └─╴ ┌───────┐ └─╴ ╷ ╵ ┌─╴ │ ╷ ╶─┬─╴ ╵ ┌─┘ ╷ ╶───┐ ╵ │
│2╷ ┌─┴───┤ ┌─┴─┘ ╷ ╵ │ ╵ ├───┤ ┌─┴───┴─┐ └─┬───┘ ╷ ╶─┬─┴───┐ ├───┴───┘ ├─┐ │ ╶─┬─┘ ┌─┼───┐ └─┐ │
├─┘ │ ┌─┐ │ └─╴ ┌─┴───┤ ┌─┘ ╷ └─┘ ┌───┐ └─┐ ├─────┤ ╷ ╵ ╷ ╶─┘ │ ╶───┬───┘ │ ├───┘ ┌─┘ ╵ ╷ └─┐ │ │
│ ╶─┤ │ │ └─────┴─╴ ╷ │ ╵ ┌─┴─────┤ ╷ └─┐ │ │ ┌─╴ │ ├───┴───┬─┴───╴ │ ╶─┬─┘ │ ┌───┴───┐ │ ╷ │ └─┤
│ ╷ ╵ ╵ │ ╶───┬─────┤ ├───┤ ┌───┐ │ └─┐ ╵ │ ╵ │ ╶─┤ │ ╶───┐ ╵ ┌───┬─┴─╴ │ ╶─┘ └───╴ ╷ ├─┘ │ ├─╴ │
│ ├─────┴─┐ ╷ │ ╷ ╷ │ │ ╷ └─┤ ╷ ╵ └─┐ └─┬─┘ ┌─┴─┐ └─┴─┬─╴ └───┘ ╷ │ ┌─╴ ├─────────┬─┘ ╵ ┌─┘ │ ╷ │
│ │ ╶───┐ └─┘ │ │ └─┘ │ ├─┐ ╵ ├───┐ └─┐ │ ╶─┘ ╷ └─┐ ┌─┘ ╶─┬─────┤ ╵ │ ╶─┤ ╶─┬─┬─╴ │ ┌───┴─┬─┘ │ │
│ ├───┐ ├─────┤ └─────┘ │ ├─╴ │ ╷ │ ┌─┘ ├─────┘ ┌─┘ │ ╶─┬─┘ ┌─╴ └─┬─┴───┤ ╷ │ ╵ ┌─┴─┘ ┌─┐ ╵ ┌─┘ │
│ ╵ ╷ │ ╵ ┌─╴ ├─┬───────┘ │ ╶─┤ │ └─┘ ┌─┤ ╶─┬───┤ ╷ └─┐ │ ╶─┴───┐ ╵ ┌─╴ │ │ │ ╶─┤ ╶───┤ └───┤ ┌─┤
├─┬─┘ ├─┬─┘ ┌─┘ ╵ ╷ ┌─────┴─┐ │ ├───┬─┘ ╵ ┌─┘ ╷ ╵ │ ┌─┘ ├───┐ ╷ ├───┤ ┌─┴─┤ └─┐ │ ┌─╴ │ ╶─┬─┘ │ │
│ ╵ ┌─┘ │ ┌─┴─────┘ │ ╶─┬─┐ ╵ │ ╵ ╷ ├─────┤ ┌─┴─╴ ├─┘ ┌─┘ ╷ └─┘ │ ╷ │ │ ╷ └─╴ │ └─┘ ┌─┤ ╷ │ ╶─┘ │
│ ┌─┘ ┌─┘ │ ╶─┬─────┴─┐ ╵ └───┴─┬─┘ │ ┌─╴ │ └─────┘ ╶─┤ ╶─┴─────┤ └─┘ ╵ ├─────┼───┬─┘ │ │ └─┬─╴ │
│ ├─╴ │ ┌─┤ ╷ ╵ ╶───┐ └───╴ ┌───┤ ┌─┘ └─┐ └─┬───┬─────┤ ┌─────┐ └───────┴─┐ ╶─┘ ╷ ╵ ╷ ╵ │ ╶─┘ ┌─┤
│ │ ╷ │ │ ╵ └─┬─────┴─┐ ╶─┬─┘ ╷ │ └───╴ ├─┐ ╵ ╷ │ ┌─╴ │ │ ┌─╴ ├───┐ ┌───┐ │ ╶─┬─┴───┼───┴─┬───┘ │
│ │ └─┤ └─┬─╴ │ ╶─┬─┐ └─┬─┘ ┌─┤ └─────┬─┘ └───┤ │ │ ╶─┤ │ │ ┌─┘ ╷ ├─┘ ╷ ╵ ├─╴ │ ┌─╴ ├─╴ ╷ │ ╶───┤
│ │ ╷ └─┐ └─┐ └─┐ ╵ ├─┐ ╵ ┌─┤ └─┐ ┌─╴ └─┐ ╷ ┌─┘ │ ├─┐ │ │ │ └─╴ │ │ ╶─┴───┤ ┌─┘ │ ╶─┘ ┌─┘ └───┐ │
│ └─┘ ┌─┴─╴ ├─╴ ├─┐ │ └───┤ ╵ ╷ │ └───┐ ╵ │ │ ┌─┘ │ ╵ ├─┘ ├─────┘ │ ┌───┐ │ ╵ ┌─┴───╴ ├─────┐ ╵ │
├───╴ │ ┌───┘ ┌─┘ │ └─┐ ╷ └───┘ ├───┐ └───┤ │ └─╴ │ ╶─┤ ┌─┤ ╶─────┤ └─┐ │ ├───┤ ╶─────┤ ┌─┐ └───┤
│ ┌───┘ │ ╶───┤ ╷ └─┐ │ └─┬─╴ ┌─┘ ╷ └─┬─╴ │ ├─┬───┴─┐ │ │ └─┬───┐ └─┐ ╵ │ ╵ ╷ ├───┬───┘ │ └───┐ │
│ │ ╷ ┌─┴───┐ └─┴─╴ │ │ ╷ └───┤ ┌─┴─┐ ╵ ┌─┘ ╵ │ ╶─┐ │ ╵ │ ┌─┘ ╷ └─┐ ├─┐ └─┬─┤ ╵ ╷ ╵ ┌───┴─┐ ┌─┘ │
├─┘ │ │ ╶─┐ ├───╴ ┌─┘ │ └───┐ │ ╵ ╷ └───┴─────┘ ┌─┘ └───┤ │ ╶─┴─┐ │ │ └─╴ │ └─┬─┴───┘ ┌─┐ ╵ │ ╶─┤
│ ╶─┴─┴─╴ │ └─┐ ┌─┘ ┌─┴───┐ │ └───┴───┬─────┐ ╶─┤ ┌───┐ │ └─┬─╴ │ ╵ │ ┌───┴─╴ │ ╷ ╶───┤ └─╴ └─┐ │
│ ╶───┬─┬─┴─┐ ├─┘ ┌─┴─┐ ╷ ╵ └─┐ ┌─────┘ ┌─┐ ├───┘ │ ┌─┘ ├─╴ │ ┌─┴───┤ └─┐ ╶─┬─┘ └─┬─╴ ├───────┤ │
├─┬─╴ │ │ ╷ ╵ │ ╶─┘ ╷ ├─┴─┬───┤ │ ╶───┬─┤ ╵ │ ┌───┘ │ ╶─┤ ┌─┘ ├───╴ └─┐ └─┐ │ ┌─┬─┘ ╷ │ ┌───┐ │ │
│ ╵ ┌─┘ │ ├───┴─┬───┤ │ ╷ ╵ ╷ ╵ ├───┐ │ ╵ ╶─┘ │ ╶─┐ └─╴ ╵ │ ┌─┘ ╶─┬───┴─╴ │ ╵ │ │ ╶─┤ │ │ ╷ ╵ │ │
│ ╶─┘ ╷ │ ╵ ┌─┐ ╵ ╷ ╵ │ └───┴─┐ │ ╷ │ └───┬───┴───┼───┬─┐ │ └───┐ │ ┌─┬───┴─┐ ╵ ├─╴ │ │ └─┤ ╶─┤ │
├───┬─┘ ├───┤ └───┼───┴───┐ ╷ │ │ │ └───┐ │ ╶─┬─┐ ╵ ╷ │ ╵ └───┐ │ │ │ ╵ ╷ ╷ └───┘ ┌─┴─┴─╴ ├─┐ ╵ │
├─╴ │ ┌─┘ ╶─┘ ╷ ╷ │ ╷ ┌─┐ └─┘ │ │ │ ┌───┘ ├─╴ │ ├───┘ │ ┌─────┘ │ ╵ └───┘ ├─────┐ │ ┌─────┘ ├─╴ │
│ ╶─┤ │ ╶─┬───┘ │ └─┤ │ └─────┤ └─┘ │ ╶───┤ ┌─┘ │ ╶─┬─┘ │ ╶─────┼───────┬─┘ ╶─┐ │ │ ├─────╴ │ ╶─┤
│ ╷ │ └───┤ ╶─┬─┴─╴ │ │ ┌─┐ ╶─┴─┬─╴ ├───┐ │ └─╴ ├─┐ └───┴───┬─╴ │ ╶───┐ └───┐ └─┘ │ │ ╶───┬─┴─╴ │
│ │ └───┐ └─┐ └─┐ ┌─┘ │ ╵ └─┐ ╶─┘ ┌─┘ ╷ │ ├───┐ ╵ └───┐ ╶───┤ ┌─┘ ╶─┐ ├─┬─╴ │ ┌───┤ └───┐ ╵ ┌───┤
├─┴─╴ ╷ ├─┐ └─╴ │ │ ╶─┤ ┌───┴─────┤ ┌─┤ │ │ ╷ └───┬─┐ └─┬─┐ │ │ ┌─┬─┘ │ ╵ ╶─┤ ├─╴ ├───┐ └─┐ └─╴ │
│ ┌───┘ │ └───┬─┘ ├─╴ ├─┘ ┌───┬─╴ │ │ ╵ │ ╵ │ ╶─┐ ╵ └─┐ ╵ │ ╵ │ ╵ │ ╶─┴─┬─╴ │ ╵ ╷ │ ┌─┴─╴ ├───┐ │
│ └───┐ ╵ ┌───┤ ┌─┘ ┌─┘ ┌─┘ ╷ │ ╶─┘ │ ┌─┴─┐ ├─┐ │ ┌───┴─┐ ├───┴─┐ ├───┐ └─┐ └───┤ ╵ │ ┌───┘ ╶─┘ │
├───┐ ├─╴ │ ╷ │ └─┐ │ ╶─┼─╴ │ └───┬─┤ ╵ ╷ │ ╵ │ ├─┘ ╷ ┌─┘ │ ╶─┐ │ └─╴ ├─╴ ├───┐ └───┘ │ ╶─┬───┬─┤
│ ╷ │ └───┘ │ └─┐ ╵ └─┐ │ ╶─┴───┐ ╵ ├───┤ ├─╴ │ ╵ ╶─┤ │ ╶─┴─┐ │ │ ┌───┘ ┌─┘ ╷ ├───────┴─┐ │ ╷ │ │
│ │ └───────┘ ╷ ├───╴ │ │ ╶───┐ └─┐ ╵ ╷ │ └─┐ ├───┐ │ └───┐ │ │ ╵ │ ╶───┤ ┌─┤ ╵ ┌─╴ ╷ ┌─┘ │ │ ╵ │
│ │ ┌───┬───╴ ├─┘ ┌───┤ ├───╴ └─┐ └───┴─┴─╴ └─┘ ╷ │ └─┐ ╶─┤ ├─┴───┤ ╶─┐ │ │ └───┤ ╶─┴─┤ ╶─┤ └─┐ │
│ └─┘ ╷ └─┐ ┌─┘ ┌─┘ ╷ │ └───┬───┴───────┐ ┌───┬─┘ ├─╴ ├─╴ │ ╵ ┌─┐ └───┘ │ └─╴ ╷ ├───┐ └─┐ └─╴ │ │
│ ┌───┴─┐ │ │ ╶─┴─╴ │ └─┬─┐ ╵ ┌───────┐ └─┘ ╷ └─┐ └───┤ ╷ └───┤ └───────┴─────┴─┘ ╷ └─╴ └─┬───┘ │
│3╵ ┌─╴ │ └─┴───┬───┴─┐ │ └───┤ ╷ ┌─┐ ├─────┴─┐ └───┐ │ ├───┐ └─┐ ┌───┬─╴ ╷ ┌───┬─┘ ┌─────┘ ┌───┤
├───┴───┴─┐ ┌─┐ └─┬─╴ │ │ ┌─╴ └─┤ │ ╵ └─┐ ╷ ┌─┴───┐ │ ╵ │ ╷ └─╴ └─┘ ╷ ╵ ╷ ├─┘ ╷ └─┐ │ ╶───┬─┴─╴ │
│ ╶───┬─┐ ╵ │ └─┐ ╵ ╷ │ │ └───┐ │ └───┐ └─┤ ╵ ╷ ╶─┤ └───┼─┴─────────┤ ┌─┴─┤ ┌─┴─┐ │ └───┐ └─┐ ╶─┤
│ ┌─╴ │ └───┘ ╷ └───┘ │ └───╴ │ │ ┌─╴ ├─╴ │ ╶─┴─┐ └───┐ ╵ ┌─────┬─╴ │ │ ╷ │ │ ╷ │ └───┬─┴─╴ ├─╴ │
│ │ ╶─┴───┐ ┌─┴───┬───┼───────┤ │ │ ╶─┤ ┌─┴─┬─┐ ├───╴ └─┬─┴─┐ ╶─┤ ╶─┤ │ │ │ │ └─┴─┬─╴ │ ╶─┬─┘ ╷ │
│ ├───┬─╴ │ ╵ ┌─╴ │ ╷ ╵ ┌─┐ ╶─┤ └─┼─╴ │ ╵ ╷ │ ╵ │ ╶─┬─╴ │ ╷ ├─╴ ├─┐ └─┘ │ │ │ ╷ ╷ │ ╷ └─┐ │ ╶─┤ │
│ └─╴ │ ╶─┴───┴───┘ └───┘ └─┐ └─╴ ╵ ┌─┴───┘ └───┴─╴ │ ╶─┘ │ ╵ ╷ ╵ └─────┤ ╵ └─┘ │ │ └───┘ └─╴ │ │
└─────┴─────────────────────┴───────┴───────────────┴─────┴───┴─────────┴───────┴─┴───────────┴─┘
