┌─┬───┬───────────────────┬─┬─────┬─────┬───┬─────────┬─────────┬─────────┬─────┬───┬─────────┬─┐
│ │ ╷ │ ┌───┬─╴ ┌───┬───┐ │ ╵ ╷ ╶─┘ ╷ ╷ └─┐ ╵ ╶─┐ ┌─┐ │ ╷ ╶─┬─╴ │ ┌───┐ ╷ ╵ ┌─╴ │ ╷ │ ╶─┐ ┌─╴ ╵ │
│ ├─┘ │ │ ╶─┤ ╶─┘ ╷ │ ╶─┘ │ ╶─┼───┬─┘ ├─╴ └─┬─╴ │ │ │ └─┤ ╷ └───┘ │ ╷ │ ├─┬─┘ ┌─┘ ├─┴─┐ │ └─────┤
│ │ ╶─┘ └─╴ ├───┐ │ │ ╶───┼─┐ ╵ ╷ │ ┌─┴─┬─╴ │ ╶─┤ │ └─┐ └─┼─────┐ │ │ │ │ │ ┌─┤2╶─┘ ╷ │ └───┬─┐ │
│ └───┬───┐ │ ╷ └─┤ └─┬─┐ │ └───┘ │ │ ╷ │ ┌─┴─┐ │ └─┐ └─╴ │ ┌─┐ └─┘ │ ╵ │ ╵ │ ╵ ┌─┬─┘ └─┬─╴ │ │ │
├─┬─╴ │ ╶─┘ │ ├─╴ └─╴ │ │ └───┐ ╶─┤ │ │ │ ╵ ╷ └─┴─┐ └─┐ ╶─┘ │ └─────┴───┘ ┌─┘ ┌─┘ │ ╶───┘ ╶─┘ │ │
│ ╵ ┌─┤ ┌───┤ └─┬─────┘ └───┐ ├─╴ │ │ │ ├───┴───┐ └─╴ ├─┬───┤ ┌─────┬─────┤ ┌─┘ ╷ └─┬───┬─────┘ │
│ ┌─┘ ╵ └─╴ ├─╴ │ ┌───┐ ╷ ┌─┘ │ ╶─┤ ╵ │ │ ╶─┐ ╶─┴─┬───┘ │ ╷ ╵ │ ┌─╴ │ ╶─┐ │ │ ┌─┴─┐ └─┐ │ ╶─┬─╴ │
│ └─┐ ┌───┐ │ ┌─┴─┘ ╷ ╵ │ │ ┌─┴─╴ ├───┤ ├─┐ └─┐ ╶─┘ ╷ ╷ │ ├───┴─┤ ╶─┴─╴ │ │ │ │ ╶─┴─╴ ╵ └─┐ └─┐ │
├─┐ └─┤ ╷ │ │ │ ╷ ╷ ├───┴─┘ ├───┐ │ ┌─┘ │ └─┐ ├─────┤ └─┤ ╵ ┌─┐ │ ╶───┬─┘ │ │ ├───┐ ╶─┬───┴─┐ │ │
│ └─┐ ╵ │ └─┤ ├─┘ │ │ ┌─────┤ ╷ │ ╵ │ ┌─┘ ╷ │ │ ╶───┴─┐ └───┘ │ ├───┐ │ ╶─┘ │ ╵ ╷ │ ┌─┘ ┌─╴ ╵ │ │
│ ╷ ├───┴─┐ │ │ ┌─┘ │ │ ┌─┐ ╵ │ └───┤ └─┐ └─┤ └─────╴ ├───╴ ╷ │ ╵ ╷ │ └─┬───┴───┘ │ │ ┌─┴─┬───┘ │
│ │ ╵ ╶─┐ │ ╵ │ │ ╶─┤ ╵ │ └───┴───┐ ├─╴ │ ╷ └───────╴ │ ╶───┤ ├───┤ ├─┐ ╵ ┌───────┤ │ ╵ ╷ ├───┐ │
│ ├───┬─┘ └───┤ │ ┌─┴───┘ ┌─┬───╴ │ │ ╶─┴─┴─┬─────────┴─┬─╴ │ └─╴ │ │ ├───┤ ┌───┐ ╵ ├───┤ ╵ ╷ └─┤
│ │ ╶─┤ ╶─┬─┐ │ │ │ ┌───┐ │ │ ┌───┤ ├─────┐ │ ╶─┬───┬─╴ │ ╶─┼─────┘ │ ╵ ╷ │ ╵ ╷ ├───┘ ┌─┴───┴─┐ │
│ └─╴ └─┐ │ │ ╵ │ │ │ ╷ │ │ ╵ ╵ ╷ │ │ ╶─┐ │ └─┐ │ ╶─┘ ┌─┴─╴ │ ╶─────┼───┤ └───┘ └─╴ ╷ │ ┌───╴ │ │
├─┬─╴ ┌─┘ │ └───┤ │ │ │ │ ├───┬─┘ │ └─╴ │ ├─╴ │ └───┐ └─╴ ╷ └─────┐ ╵ ╷ └─┐ ┌───┐ ┌─┴─┤ │ ╶───┤ │
│ ╵ ╶─┤ ┌─┤ ╷ ╶─┘ │ │ │ │ ╵ ╷ └─┬─┴─┬───┘ │ ┌─┤ ┌─┐ └─────┴───┐ ┌─┴───┼─╴ ├─┘ ╷ │ │ ╷ ╵ ├───┐ │ │
│ ┌───┘ │ ╵ └─┬───┘ │ └─┴───┴─┐ ╵ ╷ │ ╶─┬─┘ │ ╵ │3└─────────┐ └─┤ ╷ ╷ │ ╶─┘ ┌─┘ │ │ ├───┘ ╷ │ ╵ │
│ │ ┌───┘ ┌───┘ ┌───┤ ┌─┐ ┌─┐ └───┤ ├─╴ ├─╴ │ ┌─┴───────╴ ╷ └─┐ │ │ └─┴─┬─┬─┘ ┌─┘ │ └─┐ ┌─┘ ├─╴ │
│ │ │ ╶─┬─┤ ╶─┬─┘ ╶─┘ │ │ │ │ ┌───┘ │ ╶─┤ ┌─┤ └─┐ ┌─┬─────┴─┐ │ ╵ ├─╴ ╷ │ │ ╶─┼───┼─╴ │ │ ┌─┘ ┌─┤
│ │ ├─╴ ╵ ├─┐ └─┐ ╶───┘ │ │ ╵ │ ╶───┴─┐ ╵ │ └─┐ ╵ │ │ ╷ ╶───┘ ├───┘ ┌─┘ │ └─┐ ╵ ╷ ╵ ┌─┴─┘ │ ╶─┘ │
│ │ └─┬─┐ ╵ ├─╴ ├─╴ ┌───┘ │ ╶─┼───┐ ╷ └─┬─┴─╴ ├───┘ │ ├───┬───┘ ┌───┘ ┌─┘ ╷ └─┬─┴───┘ ┌─╴ ├───╴ │
│ └─┐ │ └─╴ │ ╶─┴───┘ ┌───┴─╴ ╵ ┌─┘ ├─╴ │ ╶───┤ ╶─┐ ╵ │ ╷ │ ╶─┬─┘ ╶─┬─┴───┘ ╷ │ ╶─┬─┐ └───┘ ┌───┤
│ ┌─┘ ├─────┴─╴ ┌─────┼─────┬─╴ │ ╶─┤ ╶─┼───┐ ├─╴ ├───┘ │ └─┐ ├───┐ ├─╴ ┌───┘ ├─╴ │ └─┬─────┴─╴ │
│ │ ╶─┤ ╶───────┤ ┌─╴ ╵ ┌─┐ └─┬─┴─╴ ├─┐ ╵ ╷ │ ╵ ╶─┤ ┌───┼─╴ │ │ ╷ │ ╵ ┌─┤ ┌───┤ ╶─┘ ╷ └─┬───╴ ╷ │
│ ├─╴ └─┬─────┐ │ └─────┤ └─┐ │ ┌───┘ └───┤ ├─────┘ │ ╷ │ ┌─┤ ╵ │ └───┤ │ │ ╶─┴─────┴─┐ │ ╷ ┌─┴─┤
│ │ ╷ ┌─┘ ╷ ╶─┤ ├─────┐ ├─╴ │ ╵ │ ╶─┐ ┌───┤ │ ┌─────┘ ├─┘ │ ╵ ┌─┴───╴ │ │ └─╴ ┌─┐ ┌───┘ │ ├─┘ ╷ │
├─┘ │ │ ┌─┴─┐ ╵ │ ╷ ╷ │ │ ╶─┴───┴─┐ │ ╵ ╷ ╵ │ └─┐ ╷ ╶─┤ ┌─┤ ╶─┤ ╶─┬───┘ └─┬───┤ ╵ │ ╶───┤ ╵ ┌─┘ │
│ ╶─┴─┤ │ ╷ └─┬─┴─┘ │ │ └─────┐ ╶─┤ ├───┴───┼─╴ │ └─┐ │ │ └─╴ └─┐ │ ┌─────┘ ╷ │ ┌─┴───┐ └─┐ │ ╶─┤
│ ┌─┐ ╵ │ ├─╴ ╵ ┌─╴ ├─┴─────╴ │ ╷ │ ╵ ┌───┐ ╵ ┌─┘ ┌─┘ │ ├───────┘ │ │ ┌─────┘ │ └─╴ ╷ └─┐ │ ├─╴ │
│ ╵ └─┬─┘ │ ┌───┴─┬─┘ ┌───────┤ │ └───┘ ╷ ├───┤ ╶─┤ ╷ │ ╵ ┌───────┤ ╵ │ ┌─┬─╴ ├───┐ ├───┤ │ │ ╷ │
├───┐ │ ╶─┴─┤ ┌─╴ │ ┌─┴─┐ ╷ ╷ │ └─────┬─┤ ╵ ╷ └─┐ │ ├─┴───┴─────┐ ╵ ┌─┘ │ ╵ ╶─┼─╴ │ │ ╷ │ │ │ └─┤
│ ╷ │ │ ┌─╴ │ └─┐ ╵ │ ╷ │ │ └─┴───┬─╴ │ └───┼─╴ │ │ │ ╷ ┌─────┐ └───┘ ╷ ├───┐ │ ╷ │ │ │ │ │ └─┐ │
│ │ │ └─┤ ╷ └─┐ ├───┘ │ │ └─┐ ╶───┘ ┌─┴─┐ ╷ │ ╶─┤ │ ╵ │ └───┐ └─────╴ ├─┘ ╷ │ ╵ ├─┘ │ │ │ ├───┤ │
│ │ └─┐ │ └─┐ │ ╵ ╶─┬─┤ └───┤ ┌───┐ ╵ ╷ │ └─┴─┐ │ ├───┴───┐ │ ┌─────┐ │ ╶─┤ └───┘ ┌─┤ │ ╵ │ ╷ ╵ │
│ │ ╶─┘ └─╴ ├─┴───┐ │ └───┐ ├─┘ ╷ ├───┤ │ ╷ ╶─┤ ╵ │ ╶─┐ ┌─┘ │ │ ╶─┐ └─┴─╴ └───────┘ │ ├───┘ ├─┐ │
│ ├─────┬───┤ ┌─┐ │ └─┐ ╶─┤ ╵ ╶─┤ │ ┌─┘ │ └─┐ └───┘ ╷ └─┤ ╶─┤ │ ┌─┴─────┐ ┌───┐ ┌───┘ │ ┌───┘ ╵ │
│ └─┐ ╶─┤ ╷ ╵ │ ╵ ├─╴ └─╴ ├─────┘ │ │ ┌─┴───┴─────┐ └─┐ └─┐ └─┘ │ ╶───┐ └─┘ ╷ └─┘ ┌───┘ ├───┐ ┌─┤
├─╴ └─╴ │ └───┤ ╶─┴───────┘ ┌───┬─┘ ╵ │ ╷ ╶───┬─╴ ├───┼─╴ ├───┐ ├───┐ ├─┬───┴─────┴─┬─╴ │ ╷ │ ╵ │
├───────┤ ╶─┐ │ ┌───┬───┐ ┌─┘ ╷ └───┐ └─┤ ╶─┐ │ ┌─┘ ╷ │ ╷ │ ╷ └─┘ ╷ ╵ │ ╵ ╶─┬─╴ ┌─╴ │ ╶─┘ │ ├─╴ │
│ ┌───┐ └───┘ │ │ ╷ └─┐ ╵ │ ╶─┴───┐ └─┐ └───┘ │ │ ┌─┤ ╵ ├─┘ ├─────┴─┬─┴───┬─┘ ┌─┴─┐ └─────┤ └───┤
│ │ ╷ └─┬─────┤ │ └─┐ │ ╶─┼─────┐ ├─┐ └─┬─────┤ │ │ ╵ ┌─┘ ┌─┴─┐ ╷ ╷ └─╴ ╷ │ ╶─┤ ╷ └─┬───╴ └───┐ │
│ │ └─┐ └─┐ ╶─┘ │ ┌─┘ ├─╴ └─╴ ┌─┘ │ └─┐ │ ╶───┘ ╵ │ ╶─┤ ╶─┘ ╷ └─┤ ├───┬─┘ │ ╷ ╵ └─┐ └─────┬─┐ │ │
│ │ ┌─┴─╴ │ ┌───┤ │ ┌─┴─────┐ │ ╶─┴─╴ │ └─────────┤ ┌─┴───┬─┴─┐ ╵ │ ╶─┘ ┌─┘ ├─┬───┴─────╴ │ │ ╵ │
│ ╵ │ ┌───┘ ╵ ╷ │ │ │ ╶───┐ └─┴─┬───┐ ├───┬───┬─╴ │ │ ╶─┐ ╵ ╷ └───┤ ┌───┤ ╶─┤ │ ┌───┬─────┘ └─┐ │
│ ╶─┤ └─┬───┐ ├─┘ │ └───╴ ├───┐ ╵ ╷ │ └─┐ ╵ ╷ │ ┌─┴─┴─┐ └─┬─┴─┬─╴ │ │ ╷ └─╴ ╵ │ │ ╷ ╵ ╷ ┌─────┘ │
├─╴ └─┐ ╵ ╷ └─┘ ╶─┴───────┴─╴ └───┤ └─╴ └───┘ │ ╵ ╷ ╶─┴─╴ ╵ ╷ │ ╶─┘ └─┴───────┘ │ └───┤ ╵ ╶─────┤
└─────┴───┴───────────────────────┴───────────┴───┴─────────┴─┴─────────────────┴─────┴─────────┘
