┌─┬─────────┬───────────────┬─────────┬─────────────────┬─┬───────┬─────┬─────────┬───────┬─────┐
│ └─────┐ ╷ ├───╴ ┌───────┐ └─────╴ ╷ └───╴ ┌───┬─────┐ │ ╵ ┌─┐ ╷ │ ╷ ╷ └─┐ ┌─┬─╴ │ ╶───┐ └───╴ │
├─────┐ ╵ │ ╵ ┌─┬─┘ ╷ ╶───┴───┬─────┴─┬─────┤ ╶─┘ ┌─┐ ╵ │ ╶─┘ │ └─┘ │ ├─┐ ╵ │ ╵ ┌─┴───╴ ├───┬─┐ │
│ ┌───┴─┬─┴───┤ ╵ ┌─┴─┬───╴ ╷ └─┐ ╶───┘ ╶─┐ │ ╶─┬─┘ └───┴─┬───┤ ╶─┬─┘ │ └───┤ ┌─┤ ╶─────┤ ╷ ╵ │ │
│ │ ╷ ╶─┘ ╷ ╶─┤ ┌─┴─╴ │ ╶───┼─╴ ├───┐ ┌───┘ └─┐ └─┐ ╷ ╶─┐ ╵ ╷ └─┐ │ ╶─┤ ╶─┬─┘ │ │ ╶───┐ │ ├───┘ │
│ │ └─────┴─┐ ╵ │ ╷ ╶─┴───┐ └─┐ ╵ ╷ └─┤ ╶─────┴─┐ │ ├─╴ ├───┴─┐ └─┴─╴ │ ╷ │ ┌─┘ └───┐ │ │ ╵ ╶───┤
│ └─┬─────┐ └───┴─┴───╴ ┌─┴─╴ ├───┴─┐ │ ┌───┬─╴ │ └─┤ ┌─┤ ╶───┴───────┤ │ ╵ │ ╶───┐ ╵ │ │ ┌─────┤
│ ╷ ╵ ┌─┐ ├─────────┬─╴ │ ╶───┤ ╶───┘ └─┤ ╷ ╵ ┌─┴─╴ │ │ ╵ ┌─╴ ┌─────┐ │ ├───┴───┐ ├───┤ └─┤ ┌─┐ │
│ ├───┘ ╵ └─╴ ┌─────┤ ┌─┴───┐ │ ┌───┬─╴ ╵ ├─╴ │ ┌───┘ │ ╶─┤ ╶─┤ ╷ ╶─┘ │ │ ╶─┐ ╷ │ └─╴ └─┐ ╵ ╵ │ │
│ └───────┬───┤ ┌─╴ │ ╵ ┌─┐ │ └─┤ ╷ ├───┐ ├───┤ ╵ ┌───┴───┴─┐ └─┤ ╶─┬─┤ ├───┘ ├─┴─────┐ ├─────┘ │
│ ╶─┬───┐ │ ╷ ╵ │ ╶─┴───┘ ╵ ├─┐ ╵ │ ╵ ╷ └─┘ ╷ ├───┘ ┌───┬─┐ ├─╴ ├─╴ │ │ │ ┌───┘ ┌───╴ │ │ ╶─┬─┐ │
├─╴ │ ╷ │ │ └─┬─┴───┬───────┘ ├───┼───┴─────┤ │ ╷ ╷ │ ╷ │ │ │ ┌─┘ ╶─┤ │ │ │ ┌───┤ ╶─┐ │ ├─┐ │ ╵ │
│ ┌─┘ │ │ └─┐ │ ╷ ╶─┘ ╷ ╶─┬─╴ │ ╷ ╵ ╷ ╶─┬───┤ ╵ │ └─┘ │ │ │ ╵ ├───┐ ╵ │ │ │ │ ╷ │ ╷ └─┘ ╵ │ └─┐ │
│ └───┤ │ ┌─┘ ├─┴─────┴─┐ └─┐ └─┤ ┌─┴─┐ │ ╷ └───┴─────┤ │ └─┐ │ ╷ └───┤ │ ╵ │ │ └─┴───┬───┴─╴ │ │
├───┐ │ │ │ ╶─┘ ┌─┬───╴ ├─╴ ├─╴ │ └─╴ │ │ ├───────┐ ┌─┘ │ ╶─┘ │ └─┬─┐ │ └───┤ └─┬───╴ ╵ ┌─────┤ │
│ ╷ │ │ │ └─────┘ │ ╶───┘ ┌─┤ ╶─┴─────┤ ╵ │ ╷ ┌───┘ │ ╶─┼───┐ ├─╴ ╵ │ └───┐ └─┐ ├───────┴─┐ ┌─┘ │
│ ├─┘ │ └─┬───╴ ╷ ├───────┤ └───────┐ │ ╶─┘ │ │ ┌─┐ ├─╴ │ ╷ │ │ ╶─┬─┘ ┌─┐ └─┐ │ ╵ ┌─────┐ │ ╵ ┌─┤
│ │ ╶─┼─╴ │ ╶───┤ ├───╴ ╷ │ ┌─╴ ┌─┐ │ ├───┐ ├─┘ │ ╵ │ ╶─┘ │ │ ├─╴ │ ╶─┤ └─╴ │ │ ╶─┴─┐ ╷ │ │ ╶─┤ │
│ ├─╴ │ ╶─┴─┬─┐ │ ╵ ┌─┬─┘ │ │ ╶─┤ ╵ │ │ ╷ └─┘ ┌─┤ ╶─┴─┬───┤ └─┘ ┌─┴─┐ └───┐ │ └─┬─┐ └─┘ │ └─┐ ╵ │
│ ╵ ┌─┘ ╷ ╷ │ │ ├───┘ │ ╶─┤ └─┐ ├───┘ │ ├─────┘ └───┐ │ ╶─┴─────┤ ╷ └───╴ │ └─┐ │ └───╴ └─┐ ├─╴ │
│ ╶─┴───┘ │ │ │ │ ┌─╴ └─┐ └───┘ │ ┌───┘ │ ┌─┬─────┐ │ └───┐ ┌─╴ │ ├─┬─╴ ┌─┴───┤ │ ┌───┬───┘ │ ╶─┤
├───┬───┬─┘ ╵ │ └─┤ ┌───┼─╴ ┌───┘ │ ┌───┤ ╵ │ ┌─╴ ╵ └─┬─┐ └─┤ ┌─┘ │ ╵ ╶─┤ ╶─┐ │ │ │ ╷ │ ╶───┼─╴ │
│ ╷ └─┐ ╵ ┌─┬─┴─┐ │ ╵ ╷ ╵ ╶─┤ ┌───┘ │ ╷ ├─╴ │ └───┬─╴ ╵ ├─╴ │ │ ╶─┤ ┌───┼─╴ │ │ └─┘ │ │ ╶─┐ │ ┌─┤
│ ├─╴ │ ╶─┘ │ ╷ ╵ │ ┌─┴─────┤ ╵ ┌───┘ │ ╵ ┌─┴───╴ ├───┐ │ ╶─┤ └─┐ └─┤ ╷ ╵ ╶─┤ └─────┤ ├───┘ │ ╵ │
│ │ ┌─┴─┐ ┌─┘ ├───┘ │ ┌───┐ └───┴─────┴───┘ ┌─╴ ┌─┘ ╷ │ └─┐ └─╴ └─┐ │ ├─┬───┴─┐ ╶─┬─┘ │ ┌─╴ ├───┤
│ │ ╵ ╷ └─┘ ╷ ├───┐ │ │ ╷ │ ╷ ┌─────┬───────┼───┘ ╶─┤ ├─┐ └───┬─╴ │ ╵ ╵ │ ┌─╴ └─╴ │ ┌─┘ └───┘ ╷ │
│ └─┬─┤ ┌───┴─┘ ╷ └─┤ └─┘ │ └─┘ ┌─┐ ╵ ┌───┐ │ ┌───┬─┘ │ └─╴ ┌─┘ ┌─┼─────┤ │ ┌─┬───┤ │ ┌───┬───┘ │
│ ╷ │ │ │ ╶─────┼─┐ └─┬─╴ ├─────┤ └───┘ ╶─┤ ╵ │ ╷ ╵ ┌─┘ ┌───┤ ╶─┤ │ ┌─╴ ╵ │ ╵ │ ╷ ╵ │ └─╴ │ ┌─╴ │
├─┘ │ ╵ └─────┐ ╵ ├─╴ │ ╶─┤ ┌─╴ │ ╶─┬─┬─╴ ├───┤ ├───┴─┬─┘ ╷ └─╴ ╵ │ └───┐ ├───┘ ├─┬─┘ ┌───┘ │ ╶─┤
│ ┌─┴─┐ ┌───┐ └─┐ │ ┌─┴─╴ ├─┘ ┌─┴─╴ ╵ │ ╷ └─┐ │ ╵ ┌─┐ ╵ ┌─┴─┬───┐ ├───┐ └─┤ ╶─┬─┘ │ ┌─┘ ╷ ┌─┴─┐ │
│ ╵ ╷ └─┤ ╷ └───┘ │ │ ┌───┘ ╶─┤ ┌───┐ │ ├─╴ ╵ ├───┘ └───┘ ╷ │ ╷ └─┘ ╷ └─╴ ├─╴ │ ┌─┘ │ ╶─┴─┘ ╷ └─┤
│ ┌─┴─┐ ╵ └─┬───┐ │ │ └───┬─╴ │ │ ╷ └─┘ │ ╶─┬─┘ ┌───┐ ╶───┴─┤ └───┐ ├─────┤ ┌─┘ │ ┌─┴─────┬─┴─╴ │
│ └─┐ └─┬───┘ ╷ └─┘ └───┐ │ ╷ │ │ └─┬───┴───┤ ╶─┤ ╶─┴─────┐ └───┐ └─┘ ┌─┐ │ │ ╷ ╵ └───╴ ┌─┘ ┌─┐ │
├─┐ └─╴ │ ┌───┴─┬─────╴ │ │ └─┘ ├─┐ ╵ ┌───┐ └─╴ │ ╷ ┌───╴ ├───╴ ├─────┤ │ ╵ │ ├───────┐ │ ╶─┤ │ │
│ ├───╴ │ │ ╶─┐ ╵ ╶─┬───┘ │ ┌───┘ └───┴─┐ └─────┤ │ └─┐ ┌─┘ ┌─┐ ╵ ┌─┐ │ └───┴─┤ ╶─┬─┐ │ ├─╴ │ ╵ │
│ ╵ ┌───┤ └───┴─────┘ ┌───┤ └───────┐ ╷ ╵ ┌───╴ │ ├─╴ ├─┘ ┌─┘ └─┬─┘ ╵ │ ┌───╴ │ ╷ │ ╵ └─┤ ╶─┴─┐ │
│ ┌─┘ ╷ ├───────────┬─┘ ╶─┴───────┐ ╵ ├───┤ ╶───┼─┘ ╷ │ ┌─┘ ┌─┐ ╵ ┌───┘ └─┐ ╶─┤ │ ├───┐ └───┐ │ │
│ │ ╷ ├─┘ ┌───┐ ╶─┐ │ ╶───┬─────╴ ├───┤ ╷ └───┐ │ ╷ ├─┘ │ ╶─┘ └───┴───┬─╴ ├─╴ │ │ ╵ ╷ └─┬─┐ ╵ │ │
│ └─┤ ╵ ┌─┘ ╶─┼─╴ │ └─┬─╴ │ ╶─┬─╴ ╵ ╷ │ │ ┌───┘ │ └─┤ ╶─┴───────┬───┐ │ ┌─┘ ┌─┘ └─┬─┴─┐ │ └───┤ │
├─╴ │ ╶─┴───╴ │ ┌─┴─┐ │ ┌─┴─┐ └─┬─┬─┘ ├─┘ │ ╶───┼─╴ └─────┬───┐ ╵ ╷ │ ╵ │ ╶─┴─────┘ ╷ │ ├───╴ │ │
│ ┌─┴───┐ ┌───┘ │ ╷ ╵ ├─┘ ╷ ├─╴ │ ╵ ╶─┤ ╶─┴───┐ ╵ ┌───────┘ ╷ ├───┘ │ ┌─┴─────┬───┬─┤ │ │ ╶─┐ │ │
│ │ ╷ ╷ └─┤ ╶─┬─┘ └───┤ ╶─┤ │ ┌─┴─┬─╴ └───╴ ┌─┘ ┌─┘ ┌─────┬─┘ │ ╶───┴─┘ ┌───┐ ╵ ╷ │ │ ╵ │ ╷ └─┘ │
│ ├─┘ ├─╴ └─┐ └─┬───╴ │ ╷ │ ╵ │ ╷ └─────┐ ┌─┘ ┌─┘ ┌─┤ ╷ ╷ │ ┌─┘ ┌─────┬─┘ ╶─┴───┤ │ └───┤ └─────┤
│ │ ╶─┴───┐ │ ╷ ├───┐ └─┘ │ ┌─┘ ├─────┐ │ │ ┌─┤ ┌─┤ ╵ │ ├─┘ │ ╶─┘ ┌─┐ │ ╶───┬─╴ │ └─┐ ┌─┴─┬───╴ │
│ └─────┐ │ │ │ ╵ ╷ └─────┴─┘ ╶─┘ ┌───┤ └─┘ ╵ │ │ │ ┌─┤ ╵ ┌─┘ ┌───┤ ╵ │ ┌───┤ ╷ └─┐ │ │ ╷ ╵ ┌───┤
├─────┐ ╵ │ └─┴───┴───────┬───┬─╴ │ ╷ │ ╶───┬─┘ │ │ │ └─┬─┴───┤ ╷ └─┐ └─┘ ╷ ╵ ├───┤ │ ╵ ├───┴─┐ │
├─╴ ┌─┴───┼─────┬───┬───┐ │ ╷ └───┤ │ └─────┘ ┌─┘ ╵ │ ╷ ╵ ┌─┐ │ ├─┐ └───┬─┘ ┌─┘ ╷ │ └─┐ ╵ ┌─┐ ╵ │
│ ╶─┘ ╶─┐ ╵ ╶─┐ ╵ ╷ ╵ ╷ ╵ ╵ ├───╴ ╵ ├─────────┘ ╶───┘ ├───┘ ╵ ╵ │ └───╴ └───┘ ┌─┘ └─╴ ├───┘ └─╴ │
└───────┴─────┴───┴───┴─────┴───────┴─────────────────┴─────────┴─────────────┴───────┴─────────┘
