┌─┬───────┬─────────┬─────────┬─────┬─────────────────┬───┬─────┬───────┬─────────┬─────┬───────────┬─────────┬───────────┬───────────────┬─────┬─────┬───────────────────┬─────┬─┬───┬───────────┬─┐
│ │ ╷ ┌─╴ │ ┌───┐ ╶─┘ ╷ ┌───┐ └─┐ ┌─┘ ┌─────╴ ┌─────┐ ╵ ╷ ╵ ┌─╴ └─┐ ╶─┐ └───┐ ┌─╴ │ ╷ ╷ └─╴ ╷ ┌───┐ │ ╶─┬─╴ ╷ └─┬─╴ ┌───┐ ├─────┐ ╶───┬─╴ └─╴ ╷ │ ╷ ╶─┘ ╷ ╶─────┬─────┬─╴ │ ╷ ╷ │ ╵ ╷ ╵ ╷ ┌─────┐ │ │
│ ├─┘ │ ┌─┤ │ ╶─┴─┬───┤ │ ╷ ├─╴ ╵ │ ┌─┤ ╶─┬─┬─┘ ┌─╴ │ ┌─┴───┴───┐ │ ╷ └─┬─┐ │ │ ╶─┤ │ └─┬───┘ │ ╷ │ ├───┘ ┌─┴─┐ │ ┌─┴─╴ │ ╵ ┌─┐ ├───┐ └─┬─────┴─┘ └───┬─┼─────╴ │ ╷ ╶─┘ ┌─┴─┘ │ └─┐ └───┤ └───┐ ╵ ╵ │
│ ╵ ┌─┘ │ │ └─┐ ╶─┘ ╷ │ └─┤ ╵ ┌───┘ │ ├─╴ │ ╵ ╶─┤ ╶─┘ │ ┌─────╴ │ └─┴─╴ │ ╵ │ ├───┘ ├─┐ │ ┌───┘ │ │ │ ┌─┬─┘ ╷ ╵ │ │ ╷ ╶─┴───┘ ╵ │ ╷ └─┐ ╵ ╶───┬─────┐ ╵ │ ╶─┬───┘ └─┬───┘ ┌───┴─┐ ├───┐ ├───╴ │ ┌───┤
├───┤ ┌─┘ └─╴ └─┬───┤ └─┐ └─┐ │ ╶───┘ │ ╶─┴─────┤ ╶─┬─┘ │ ╶─┬───┘ ┌───┬─┘ ╶─┘ │ ┌───┘ │ ├─┘ ┌─┬─┘ │ ╵ │ ╵ ┌─┴───┤ └─┤ ╶───────┬─┘ ├─╴ ├───────┤ ┌─┐ ├─┐ └─┐ └───┬─╴ ╵ ┌───┴───┐ │ └─┐ ╵ │ ╶─┐ ├─┘ ╷ │
│ ╶─┘ │ ┌─────┐ ╵ ╷ └─╴ └─┐ │ ├───┬─╴ ├───┬───┐ ├───┤ ┌─┴─┐ │ ┌───┘ ╷ └───┬───┘ ╵ ┌───┤ ╵ ┌─┘ │ ╶─┴─┬─┘ ┌─┴─╴ ╷ │ ╷ └───────┐ │ ┌─┘ ┌─┘ ┌───┐ ╵ │ │ │ │ ┌─┴───┐ └─┬───┴─┐ ╷ ╷ │ └─┐ ├───┤ ╷ ├─┘ ╶─┤ │
│ ┌───┤ │ ┌─┐ └─┐ ├─────┐ │ │ │ ╷ │ ╶─┘ ╷ ╵ ╷ │ │ ╷ │ │ ┌─┘ │ │ ╶───┴───┐ ╵ ┌───┬─┘ ╷ └─┐ ╵ ┌─┴─┐ ╷ │ ╶─┘ ┌───┤ │ └───────┐ │ │ │ ┌─┴─╴ │ ╶─┴─┬─┘ ╵ │ │ │ ┌─╴ ├─╴ │ ┌─╴ │ │ │ │ ╷ │ │ ╷ └─┤ ╵ ┌───┤ │
│ │ ╶─┘ │ │ └─╴ │ │ ╶─┐ │ │ │ └─┘ └─┬─┬─┴───┤ │ │ │ │ ╵ │ ┌─┴─┴─┬─────╴ ├───┘ ╷ │ ┌─┴─┐ └───┘ ╷ │ │ ├─┬───┘ ╷ │ ├───────┬─┘ │ ╵ │ │ ╷ ┌─┘ ┌─╴ │ ╶─┬─┤ ╵ │ │ ╶─┘ ╷ │ │ ┌─┤ │ │ └─┘ │ ╵ ├─╴ ├───┘ ╷ ╵ │
│ ├─────┤ │ ╶───┴─┴─╴ │ │ │ ├─────┐ ╵ │ ┌─┐ ╵ │ ╵ │ └─╴ │ │ ┌─┐ ╵ ┌─────┘ ╷ ┌─┴─┤ ╵ ╷ │ ┌───┬─┘ └─┤ │ ╵ ╷ ┌─┴─┘ │ ┌───┐ │ ╶─┼───┤ │ │ └───┤ ┌─┴─╴ │ ╵ ╶─┤ └─────┼─┘ │ │ ╵ │ ├───╴ ├───┤ ┌─┘ ╶───┴───┤
│ │ ┌─╴ │ └─────┬───┬─┘ │ │ └─┐ ╷ └─┐ │ ╵ └───┴───┼─────┤ ╵ │ └───┤ ╶─┬───┤ ╵ ╷ └───┤ └─┤ ╷ └─┬─╴ │ │ ┌─┤ ╵ ┌───┤ ╵ ╷ │ └─╴ │ ╶─┤ │ ├─┬─╴ │ ╵ ╶───┴───┬─┴─┐ ┌─┐ ╵ ┌─┘ ├───┘ │ ╶─┬─┘ ╷ │ │ ┌─────┬─╴ │
│ │ │ ┌─┤ ┌───╴ │ ┌─┘ ╶─┴─┤ ╷ └─┴─┐ ╵ └───────┬─╴ │ ╶─┐ ├───┴─┐ ╷ └─┐ └─╴ ├───┴───╴ ├─┐ ╵ └─┐ │ ╶─┘ │ │ └─┬─┘ ╷ ╵ ┌─┤ └─┬───┤ ╷ ╵ │ ╵ │ ╶─┴─────┬───┐ ╵ ╷ │ ╵ └───┤ ┌─┤ ╶─┬─┴───┘ ┌─┤ ╵ │ │ ╷ ╷ │ ╶─┤
│ ╵ │ │ │ │ ╶─┬─┘ ╵ ┌───┐ └─┴───┐ ├───────────┤ ┌─┘ ╷ │ │ ╶─┐ │ └───┘ ┌───┘ ┌─────╴ ╵ ├─────┤ └───┬─┘ │ ╶─┤ ┌─┴───┤ └─┐ │ ╷ ╵ ├───┴───┤ ┌───┐ ╷ ╵ ╷ └─┬─┤ ├─────┐ │ │ ╵ ╷ ╵ ┌─────┘ └───┤ │ │ └─┴─┐ │
├───┘ │ ╵ └─┐ └───┬─┘ ╷ ├─────┐ │ │ ┌───────┐ │ └─┬─┘ │ │ ╷ │ │ ┌───┐ │ ╶─┬─┘ ╶─┬───┐ │ ┌─╴ ├───╴ │ ╶─┤ ╷ │ ╵ ┌─╴ ╵ ┌─┘ ├─┴─┐ ├─╴ ┌─╴ └─┘ ╷ │ ├───┼─╴ │ │ │ ┌─┐ │ │ │ ╶─┼───┴───┐ ╷ ╶─┐ │ └─┴─┬─╴ │ │
│ ╶───┼─────┴─┐ ╷ ╵ ╶─┤ └───┐ ╵ ╵ │ │ ╷ ╷ ┌─┘ ├─╴ ╵ ┌─┘ │ │ │ └─┤ ╷ └─┴─┐ │ ┌─┬─┘ ╷ └─┤ │ ╶─┘ ╷ ┌─┴─┐ │ │ └───┤ ┌─┬─┘ ┌─┘ ╷ │ ╵ ┌─┴─┬─────┤ │ ╵ ┌─┘ ┌─┘ │ ╵ │ │ └─┘ ├─╴ │ ╶─┬─╴ ├─┴─╴ ├─┴───┐ │ ╶─┤ │
├─┬─╴ │ ┌───╴ │ └─┬───┴───┐ └─────┤ └─┤ └─┤ ╶─┘ ┌───┤ ╶─┴─┤ └─┐ │ └─┬─┐ ╵ │ │ │ ╶─┴─┐ │ └───┬─┘ │ ╷ │ └─┴─┐ ╷ │ │ │ ╷ │ ┌─┘ ├───┘ ╷ │ ┌─╴ │ └───┘ ┌─┴─┐ └───┘ └─┬───┤ ╶─┴─╴ │ ┌─┘ ┌─╴ │ ╶─┐ ╵ ├─╴ │ │
│ ╵ ┌─┘ │ ┌───┴───┘ ┌───┐ └───┬─╴ ├─╴ ├─╴ ├───┬─┘ ╷ └───┐ └─╴ │ └─╴ │ └───┤ ╵ └─┬─┐ │ └─┐ ╷ ├───┤ │ └─┬─╴ │ └─┘ │ │ └─┘ │ ╶─┘ ╶─┬─┘ │ └─┐ └───┬───┘ ╷ │ ╷ ╶─┐ ┌─┘ ╷ └───┬─┬─┘ │ ╷ └───┼─╴ ├───┘ ┌─┘ │
│ ╶─┴─╴ │ ╵ ┌─┬─────┘ ╷ └─┬─╴ │ ╶─┘ ╶─┘ ┌─┘ ╷ │ ╶─┼───╴ ├───┬─┴─┬───┴───╴ ├─┬─╴ │ │ └─┐ │ │ ╵ ╷ ╵ └─┐ └─┐ └─┐ ╶─┤ └─────┴───┬───┤ ┌─┘ ╷ └─┬───┘ ┌─╴ │ └─┤ ╷ │ │ ┌─┴─┐ ╷ ╵ │ ┌─┤ ├───┐ ╵ ┌─┴───╴ │ ╷ │
├───────┴───┘ │ ┌─┬───┴─┐ │ ┌─┴─────┐ ┌─┘ ┌─┘ │ ╷ └─┐ ┌─┘ ╷ └─╴ │ ┌─╴ ┌─╴ │ │ ┌─┘ ├─╴ │ └─┴───┴─────┴─╴ ├─┐ ├─╴ └─┐ ╷ ╶─┐ ┌─┘ ╷ │ ├───┤ ╷ ╵ ╶───┤ ┌─┴─┐ └─┤ │ │ │ ╶─┤ └───┘ │ ╵ │ ╶─┴───┴─╴ ╷ ┌─┘ │ │
├─╴ ┌─────────┘ │2│ ┌─╴ │ ╵ │ ╷ ┌─┐ └─┤ ┌─┴─┐ └─┼─╴ │ │ ╶─┤ ┌───┤ │ ╶─┴─┐ ╵ │ ├─╴ │ ┌─┴─────┬───┬─────┬─┘ │ └───┐ └─┴─╴ │ │ ┌─┤ │ │ ╷ └─┤ ┌─┬───┘ │ ╷ └─┐ ╵ ├─┘ ├─╴ └─┬─────┤ ╶─┴─────╴ ┌───┤ │ ┌─┘ │
│ ┌─┘ ┌─────────┘ ╵ │ ╷ └───┴─┘ │ └─┐ │ ╵ ╷ └─┐ ╵ ┌─┤ └─┐ └─┘ ╷ ╵ └───┐ └───┘ ╵ ╷ │ │ ┌─╴ ╷ └─╴ │ ╷ ╷ │ ╷ └───┐ ├─╴ ┌───┤ │ │ ╵ │ ╵ └─┐ │ ╵ │ ┌───┤ │ ╶─┘ ┌─┘ ┌─┘ ┌─╴ ╵ ┌─╴ └─┬───┬─────┘ ╷ ╵ │ └─┐ │
│ ╵ ┌─┴─────┬───────┘ ├───┬─────┴─╴ │ └───┴─╴ ├───┘ ├─╴ ├───┬─┴───────┴───┐ ┌───┴─┤ └─┤ ┌─┘ ┌───┘ │ │ ╵ ├───╴ │ └───┘ ╷ └─┤ └─┐ └─────┤ │ ┌─┘ │ ╶─┘ ├───┐ │ ┌─┘ ┌─┴───┐ ├───┐ │ ╷ │ ╶─┬─┬─┴───┤ ╷ │ │
│ ┌─┘ ╶───┐ ╵ ┌───────┴─┐ ╵ ╶─┐ ╶───┴─────┬───┘ ╶─┬─┘ ┌─┘ ╷ ╵ ┌─────────┐ └─┘ ┌─╴ │ ╷ │ └─┬─┘ ┌───┘ ├─╴ ├───┐ └─┬─────┴─┐ └─╴ ├─┬───╴ │ └─┤ ┌─┴─────┘ ╷ │ │ │ ╶─┘ ╶─┐ └─┤ ╷ │ │ │ └─╴ ╵ │ ╶─┐ └─┘ │ │
│ ├─────╴ ├───┤ ╷ ╶───┐ └─────┴─┐ ┌───┐ ╷ └─────╴ │ ┌─┘ ╷ └───┼─────┬─╴ └─────┤ ╶─┴─┘ │ ╷ │ ╶─┤ ╶─┬─┘ ┌─┘ ╷ │ ┌─┘ ╷ ╶───┴─────┘ │ ┌───┴─╴ │ │ ╶─┬─────┤ ├─┘ │ ╶─┬───┴─┐ ╵ │ │ ├─┴─────┬─┴─╴ ├───┬─┘ │
│ ╵ ┌─────┴─╴ │ ├───┐ └─┬─────┐ │ ╵ ╷ │ │ ┌───┬─╴ │ │ ╶─┴───┐ ╵ ╶─┐ │ ╶─────┬─┴───┬───┘ │ ╵ ┌─┴─┐ └─┐ │ ┌─┤ └─┘ ┌─┴───┬───┐ ╶─┐ │ └─╴ ┌─┬─┘ └─┐ │ ╶─┐ │ │ ┌─┴───┘ ┌─╴ └───┘ │ ╵ ┌───┐ ╵ ┌───┴─╴ │ ╶─┤
├─┬─┘ ┌───┐ ╶─┤ │ ╷ └─┐ │ ┌─╴ │ └─┬─┘ │ └─┘ ╷ ├───┘ │ ┌───┐ └─┬─┬─┘ │ ┌───┐ ╵ ╷ ╶─┘ ┌───┴─┬─┘ ╷ └─╴ │ │ │ └─────┘ ┌─┐ └─┐ ├─╴ ├─┴─────┤ ╵ ╷ ┌─┘ ├───┘ │ ╵ │ ╷ ┌───┴─┬───────┼───┘ ╷ └─┬─┘ ╶─────┴─╴ │
│ ╵ ┌─┘ ╷ ├─╴ │ │ ├─╴ │ │ └─┬─┴─╴ ├───┴─┬───┘ │ ╶─┬─┴─┘ ╷ ├─╴ ╵ │ ╶─┤ └─╴ └─┬─┴─────┤ ╶─┐ │ ╶─┼─────┤ │ ├─╴ ┌───┬─┘ ├─╴ │ │ ┌─┘ ╶─┐ ┌─┘ ┌─┘ │ ┌─┘ ╶───┴─┬─┘ └─┤ ╶─┐ │ ╷ ┌─╴ │ ┌───┴─┐ │ ┌───────────┤
│ ╶─┴───┘ │ ╶─┤ ├─┘ ╷ │ │ ╷ ╵ ╶───┘ ┌─╴ │ ┌─┐ ├─┐ │ ╷ ┌─┤ └─┬─╴ └─┐ └─┬─┬─╴ │ ╷ ╶───┘ ┌─┘ └─┐ │ ╶─┐ │ │ │ ╶─┤ ╷ ├─╴ │ ┌─┘ │ ╵ ┌───┤ │ ╶─┤ ╷ │ │ ╶───┐ ╶─┤ ╶─┐ ├─╴ │ ├─┘ ├───┘ │ ┌───┤ │ └─┬─╴ ┌───┐ │
├─╴ ┌─────┴─┐ │ ╵ ┌─┘ │ └─┴───────┬─┴─┐ ╵ │ ╵ │ │ └─┘ │ └─┐ │ ┌───┴─╴ │ │ ┌─┴─┴─┐ ╶─┬─┘ ┌─╴ │ └─╴ │ ├─┘ ├─╴ │ │ │ ╶─┘ └─╴ ├───┤ ╷ ╵ ├─╴ │ │ │ └─┬─╴ ├─╴ └─┐ │ ╵ ┌─┤ │ ╶─┘ ┌───┘ │ ╷ ╵ └─┐ ╵ ┌─┤ ╷ │ │
│ ┌─┘ ┌───┐ │ └───┘ ╶─┴─┬───────┐ ╵ ╷ ├───┤ ┌─┘ └─────┘ ┌─┘ │ │ ┌─────┤ ╵ │ ╶─┐ └───┤ ╶─┤ ┌─┴─┬───┘ │ ╶─┤ ┌─┘ │ ├─────┬─╴ │ ╷ │ └─┐ │ ╶─┤ ├─┴─┐ │ ┌─┘ ┌───┤ └─┬─┘ │ └───┐ │ ╶─┬─┘ │ ┌───┴───┤ ╵ │ │ │
├─┘ ┌─┤ ╷ │ └───────────┤ ╶─┬─┐ └─┬─┘ │ ╶─┤ └─────┬─╴ ╷ │ ┌─┴─┘ │ ╷ ╶─┘ ┌─┴─╴ ├───┐ └─╴ │ ╵ ╷ │ ┌───┴─╴ │ │ ╶─┤ │ ┌─┐ └───┤ │ └─┐ ├─┴─╴ │ ╵ ╷ ╵ │ │ ╶─┘ ╷ └─┐ │ ╶─┴───┐ │ │ ╷ │ ┌─┘ │ ╷ ╶─┐ │ ╶─┤ ╵ │
│ ┌─┘ ╵ │ ╵ ┌───┐ ┌───┐ └─╴ │ └─┐ │ ┌─┘ ╷ └─────╴ ╵ ╷ ├─┘ │ ╷ ╶─┴─┤ ┌───┤ ┌───┘ ┌─┴───┬─┴───┘ │ ╵ ┌───┬─┘ └─┐ │ │ │ └───┐ ╵ ├─┐ ╵ │ ╶─┬─┴───┴───┤ ├─────┤ ╷ ╵ ├───╴ ╷ │ │ └─┘ │ ├───┘ ├─┐ └─┼─╴ ├───┤
│ └───┐ ├─┬─┘ ╷ └─┘ ╷ └─┬───┴─┐ ╵ │ │ ╶─┼─────┬───┬─┘ │ ┌─┴─┴───┐ │ │ ╷ ╵ │ ╷ ╷ │ ╷ ╷ │ ┌─────┴───┘ ╷ ╵ ╷ ┌─┘ │ ╵ │ ╶─┐ └───┘ └─┐ └─┐ └─┬─╴ ┌─╴ │ │ ╶─┐ │ └─┬─┘ ┌───┴─┤ └───┐ │ │ ┌───┘ └─┐ │ ╶─┘ ╷ │
│ ┌─╴ │ │ │ ╶─┴─────┼─┐ ╵ ┌─┐ │ ┌─┘ ├─┐ │ ┌─┐ ╵ ╷ └───┘ ├─╴ ┌─┐ │ │ │ └─┬─┴─┤ └─┤ │ └─┤ └─┬─────┬─╴ ├───┴─┘ ┌─┴───┘ ╷ ├─┬───┐ ┌─┴─╴ └─┐ │ ╶─┴─┐ └─┤ ╷ │ └─┐ └─┐ │ ┌─╴ ├─┬─╴ │ │ ╵ │ ╷ ┌─┐ │ ├─────┤ │
├─┘ ┌─┘ ╵ └─┬─────┐ ╵ ├───┘ │ │ └─┐ │ ╵ │ ╵ └─┬─┴─┬─────┤ ┌─┤ ╵ │ │ └─╴ │ ╷ └─╴ │ ├─╴ ├─┐ ╵ ┌─┐ │ ╶─┤ ┌─────┴─┐ ┌───┘ │ ╵ ╷ ╵ │ ╶─┬───┘ │ ┌─╴ ├─┐ └─┘ ├─╴ ├─┐ │ ╵ │ ╷ ╵ │ ┌─┴─┴─┐ │ │ │ ╵ │ │ ╷ ┌─┘ │
│ ┌─┘ ┌─────┘ ┌─╴ └─┐ └─┬─╴ │ └─┐ ╵ ├───┴───┐ │ ╷ ├─╴ ╷ ╵ │ │ ┌─┘ ├───┬─┘ │ ┌───┘ │ ╷ │ └───┤ │ └─╴ │ ╵ ╶───┐ └─┤ ┌─╴ ├───┤ ╶─┼─╴ │ ╶─┬─┴─┤ ╶─┤ └─┬───┘ ┌─┘ ╵ └───┘ ├─╴ │ │ ┌─╴ │ └─┤ └─┐ │ ╵ │ ╵ ┌─┤
│ │ ╶─┤ ┌─────┤ ┌─┐ └─┐ │ ╷ ├─┐ └───┘ ┌─┬─╴ │ ╵ │ │ ┌─┴─┬─┘ │ │ ╷ │ ╶─┘ ╷ └─┤ ┌───┤ │ ╵ ┌─╴ ╵ ├───╴ ├───┬───┴─╴ │ └───┤ ╷ └───┘ ╶─┼─┐ │ ╷ └─┐ │ ╷ ╵ ┌───┼───┬───┐ ┌─┴───┤ ╵ │ ┌─┴─╴ └─╴ │ └───┴───┘ │
│ └───┘ ├───┐ │ │ └─┐ │ ╵ │ │ └───────┘ │ ╶─┴─┬─┘ │ ╵ ╷ │ ╷ │ ├─┘ │ ╶───┼─╴ │ └─╴ │ └─┬─┴─┬─╴ │ ╶─┬─┴─╴ │ ╶─────┴───┐ ╵ ├─┬───┬─┐ ╵ │ ╵ ├─╴ │ │ └───┘ ╷ ╵ ╷ │ ╷ │ │ ┌─┐ │ ╶─┤ ├─────────┴─────┬───┐ │
│ ┌─────┘ ╷ │ │ │ ┌─┘ └───┤ ╵ ┌─────┬─┐ ├─┐ ╶─┘ ┌─┴───┤ │ └─┤ ╵ ┌─┴─────┘ ╷ ├───╴ ├─┐ ╵ ╷ ├───┴─╴ ├─╴ ╷ ├─────────┐ └─┐ ╵ │ ╷ │ └─┐ ├───┤ ╶─┘ ├───────┴───┘ │ └─┘ │ │ ╵ ├───┤ ╵ ┌───────────┐ │ ╷ │ │
│ ├─╴ ┌───┘ ╵ │ │ ╵ ╶─┬───┴───┘ ╶─┐ ╵ │ ╵ ├─────┘ ┌─┐ │ └─┐ └───┘ ╷ ┌─────┤ │ ╶───┘ ├───┤ │ ╶───┬─┘ ┌─┘ │ ╶─┬───╴ └─┐ ├───┤ │ │ ╶─┘ │ ╶─┴─────┤ ╶───────────┤ ┌───┤ │ ╶─┘ ╷ ├───┘ ┌───┬───╴ │ ╵ │ └─┤
│ ╵ ┌─┘ ┌───┐ │ │ ┌───┤ ┌───────┐ └───┴─┐ └─┐ ┌───┤ ╵ ├─╴ │ ╷ ╷ ┌─┴─┘ ╶─┐ │ ├─────╴ │ ┌─┘ ├───╴ │ ╶─┤ ╶─┴─┐ │ ┌─╴ ┌─┘ │ ╷ ╵ │ │ ╶───┴───╴ ╷ ┌─┴───┬─────┬─╴ │ │ ╷ │ └───┬─┤ │ ┌───┘ ┌─┘ ┌───┤ ╶─┼─╴ │
├───┘ ┌─┘ ╷ └─┤ └─┘ ╷ │ ╵ ┌───┬─┴─┐ ╶─┐ └─┐ ╵ │ ╷ ╵ ┌─┘ ┌─┴─┘ │ │ ╶───┬─┘ ├─┘ ┌───┬─┘ │ ╷ │ ╶───┴─╴ ├───┐ │ │ ├───┤ ┌─┘ ├───┤ ├───────┬───┴─┤ ╷ ╷ ╵ ┌───┤ ┌─┘ ╵ │ ├───╴ │ │ ╵ │ ╶───┤ ╶─┘ ╷ └───┤ ╶─┤
│ ╶───┤ ┌─┼─╴ │ ┌───┤ └─┐ │ ╷ ╵ ╷ └───┤ ╶─┴───┤ └─┬─┴─╴ │ ┌───┴─┴─┐ ┌─┘ ╷ │ ┌─┘ ╷ ╵ ┌─┘ ├─┴─────┬───┘ ╷ │ ├─┘ │ ╷ │ ╵ ┌─┘ ╷ │ │ ┌─┬─╴ │ ╶─┐ │ │ ├───┘ ╷ │ ├─────┴─┘ ┌───┘ └───┴───╴ ├─────┼───┐ └─╴ │
│ ┌───┘ │ ╵ ╶─┴─┘ ╷ └─╴ │ │ └───┴───┐ └───╴ ╷ ├─╴ ├─╴ ┌─┘ │ ┌─┬─╴ │ │ ┌─┘ │ └─┐ └─┐ │ ╶─┘ ╶─┬─╴ │ ╶───┤ ╵ │ ╶─┤ │ ├───┘ ┌─┤ │ ╵ │ │ ┌─┘ ┌─┘ │ │ ╵ ┌───┤ ╵ │ ╶─┬─┬───┘ ╶───────┬───┐ └─╴ ╷ │ ╷ ├───┐ │
│ │ ┌───┤ ┌─────┬─┴───┐ │ ├─────┬─╴ ├─────┐ ├─┘ ┌─┘ ┌─┘ ╶─┤ ╵ │ ╶─┘ │ │ ╶─┼─╴ │ ╷ └─┴─┬─────┘ ┌─┴───╴ ├───┘ ╷ ╵ │ ╵ ╷ ┌─┘ ╵ ├───┘ │ ╵ ┌─┤ ╶─┤ └─┬─┘ ╷ ├───┴─╴ │ ╵ ┌───────┬─╴ │ ╷ └─────┤ ╵ │ │ ╷ │ │
│ │ ╵ ╷ └─┘ ┌─╴ │ ╷ ╶─┘ │ │ ╶───┤ ┌─┘ ┌─┐ └─┘ ┌─┘ ╷ │ ┌─╴ └─┐ └───┬─┘ │ ┌─┘ ┌─┴─┴─┐ ┌─┘ ┌───┐ │ ┌─────┴───┐ └─┬─┴───┤ │ ┌───┘ ╶─┐ └─┬─┘ └─┐ └─┐ ├─╴ │ │ ╶─────┴───┤ ╶─┬─┐ │ ┌─┘ │ ┌─────┴───┘ │ ├─┘ │
│ └───┼───┬─┤ ╶─┴─┴─────┤ ├───╴ │ │ ╶─┤ └─────┴─┐ │ │ │ ┌─╴ └───┐ │ ╶─┴─┘ ┌─┤ ╷ ╷ ╵ │ ┌─┘ ╷ ╵ │ │ ╷ ┌───╴ ├─╴ └─╴ ┌─┘ │ └───────┘ ╷ │ ┌─╴ └─┐ │ ╵ ┌─┤ └───┐ ╶───┐ │ ╷ │ ╵ ╵ ├───┤ ╵ ╶─────┬───┘ │ ┌─┤
├─┬─╴ │ ╷ │ └───┬─────┐ ╵ │ ╷ ┌─┘ └─┐ │ ┌─╴ ┌─╴ ├─┘ │ │ └─────┬─┘ ├───────┤ ╵ │ ├─╴ │ └───┴───┘ │ │ │ ╶───┴─┬─╴ ┌─┘ ┌─┴─┬─────────┤ └─┤ ╶─┐ │ ├───┘ ├───┐ └─┬─╴ │ │ │ ├───┬─┘ ╷ └─┬─────╴ ╵ ╷ ┌─┘ │3│
│ ╵ ╶─┘ │ ╵ ┌─╴ ╵ ┌─╴ └───┘ │ │ ╶───┘ └─┘ ┌─┘ ╶─┘ ┌─┘ └─────┐ ╵ ╶─┴─╴ ┌─╴ └───┘ │ ╶─┴───────────┴─┘ ├─────╴ └───┘ ┌─┘ ╷ ╵ ╶─┐ ╶───┴─╴ └─╴ │ │ ╵ ╶─┐ ╵ ╷ └─╴ └───┘ │ │ ╵ ╷ ╵ ╶─┴─┐ └─────────┴─┘ ╶─┘ │
└───────┴───┴─────┴─────────┴─┴───────────┴───────┴─────────┴─────────┴─────────┴───────────────────┴─────────────┴───┴─────┴─────────────┴─┴─────┴───┴───────────┴─┴───┴───────┴───────────────────┘
