┌─┬───────────┬─────┬───┬───────────┬─────────────┬───┬───┬───────────────┬───────────────┬───┬───────────┬───────────┬───────────┬───┬─────┬───────┬───┬───────┬───────────────────────┬───────┬───┐
│ │ ┌───┬─╴ ╷ │ ╶─┐ ╵ ╷ ╵ ╷ ┌───────┘ ┌─┬─╴ ┌───┐ └─┐ ╵ ╷ │ ╶───┬─╴ ┌───╴ │ ╷ ┌─────────╴ └─╴ │ ╶─┬───┐ ╷ └─┐ ┌─┐ ╶─┬─┘ ╷ ╶───┬─╴ ╵ ╷ └───╴ │ ╶───┐ ╵ ╷ ╵ ┌───╴ │ ┌─────┬─┬─────────╴ ╷ │ ╷ ╶─┐ │ ╶─┤
│ └─┤ ╷ │ ┌─┘ │ ╷ ├───┤ ┌─┴─┤ ┌───┬───┘ │ ┌─┘ ╷ ├─╴ └───┘ ├─┬─╴ │ ╶─┴───┐ └─┤ │ ┌─────┬─────┐ │ ┌─┘ ╷ │ └─┐ │ ╵ ├─╴ │ ╶─┼───┐ └─────┼─────╴ └─┬─╴ ├───┴─┬─┘ ┌─╴ │ ├─╴ ╷ │ │ ┌─────────┤ └─┼─╴ │ │ ╷ │
├─┐ │ │ │ │ ╶─┤ │ ╵ ╷ ├─┘ ╷ ╵ │ ╶─┘ ╷ ╶─┤ ╵ ┌─┤ └─┬─────┐ ╵ │ ┌─┴─┬───┐ ├─┐ │ │ ╵ ┌─╴ │ ┌─┐ │ │ │ ╶─┤ └─╴ │ └───┘ ╷ └─┐ └─╴ └───┬─┐ │ ┌───────┘ ┌─┘ ┌─╴ │ ╶─┼───┤ │ ┌─┤ │ │ └─────┐ ╶─┴─┐ ╵ ┌─┤ └─┤ │
│ ╵ │ │ │ └─┐ │ ├───┤ ╵ ┌─┴───┤ ╶─┬─┴─╴ └─┬─┘ └─┐ ╵ ┌─┐ ├───┘ └─╴ │ ╷ ╵ │ ╵ │ └───┴───┘ ╵ │ └─┘ ├─╴ ├─────┼───────┤ ┌─┴─────┬─┐ │ │ └─┤ ┌───────┘ ╶─┤ ╷ ├─┐ ╵ ╷ ╵ │ │ ╵ ╵ ├─────┐ │ ╶─┐ └───┘ └─┐ │ │
│ ╶─┘ │ ├─╴ │ │ │ ╷ │ ╶─┘ ┌─┐ │ ┌─┘ ┌───┐ │ ╶───┴───┘ │ │3╶─┬─────┤ ├───┤ ╶─┼───┐ ╶─────┬─┴─┐ ┌─┘ ┌─┘ ╷ ╷ ╵ ┌─────┘ │ ┌─╴ ╷ ╵ │ ╵ └─┐ │ └─┬───┬─────┤ │ ╵ └───┼─┬─┘ └─┬─╴ ╵ ┌─╴ │ ├─┐ └───┬─┬─╴ │ │ │
├─────┤ │ ╶─┤ └─┘ │ └───┬─┘ │ └─┘ ┌─┴─╴ │ └───┐ ╷ ╶─┬─┘ │ ┌─┘ ┌─╴ │ │ ╶─┴─┐ ╵ ╷ │ ┌───┬─┘ ╷ └─┤ ┌─┤ ┌─┤ └─┬─┘ ┌───┬─┤ │ ╶─┴─┐ ├───╴ │ └─┐ │ ╷ ╵ ┌─╴ │ └─────┐ │ ╵ ┌─╴ ├───┬─┘ ╶─┤ │ ├───╴ ╵ │ ╷ │ ╵ │
│ ╷ ╷ │ ├─╴ ├─────┴─┬─╴ │ ╶─┴─────┘ ╷ ╶─┴───╴ └─┤ ╷ │ ┌─┘ │ ┌─┘ ╶─┤ └─┐ ╶─┼───┘ ├─┘ ╷ ╵ ┌─┴─┐ │ │ ╵ │ └─┐ ╵ ┌─┘ ╷ ╵ │ └───┐ └─┘ ┌───┴─┐ │ ╵ ├───┤ ┌─┴─────╴ │ │ ┌─┘ ┌─┘ ╷ └─────┤ │ ╵ ┌───┬─┘ ├─┴─╴ │
│ │ └─┤ ╵ ┌─┘ ┌─┐ ╶─┤ ╶─┴─┐ ┌───┐ ╶─┼─────────┐ └─┤ │ ╵ ┌─┘ ├───┐ └─╴ │ ╷ │ ╶─┬─┘ ┌─┴─┬─┘ ╷ ╵ ╵ │ ┌─┘ ┌─┴─┐ ╵ ┌─┤ ┌─┴───╴ ├─────┤ ┌─┐ │ └───┘ ╷ ╵ │ ┌───┬───┘ │ │ ╷ │ ╶─┼─────┐ ╵ │ ╶─┘ ┌─┘ ┌─┘ ┌───┤
│ ├─╴ └─┬─┘ ┌─┘ └─┐ └───┐ └─┤ ╷ ├───┘ ┌─────┐ ├─╴ ╵ ├───┤ ╶─┤ ╷ └─────┴─┤ └─┐ │ ╷ │ ╷ │ ┌─┴───┬─┤ │ ╷ │ ╷ ├───┘ ╵ │ ╶─┬───┘ ┌─╴ │ │ │ ├───────┴───┘ │ ╶─┤ ╶─┬─┴─┘ │ ├─┐ ╵ ╶─┐ └───┼─┬─╴ │ ╶─┤ ┌─┘ ╷ │
│ │ ╷ ┌─┘ ┌─┘ ┌─╴ │ ╶─┐ ├─┐ ╵ │ ╵ ┌───┴───┐ │ └─┬─╴ │ ╷ └─┐ ╵ └───┬───╴ │ ╷ ╵ │ ├─┘ │ └─┤ ┌─╴ │ ╵ │ ├─┘ │ │ ┌─────┼─╴ │ ╶───┤ ┌─┘ ╵ │ ╵ ╶─┐ ╶─────┬─┘ ╷ └─╴ ╵ ┌───┘ ╵ ├─────┤ ╶─┐ │ ╵ ┌─┴─┐ │ │ ┌─┴─┤
│ │ │ │ ┌─┴───┤ ┌─┴─╴ │ │ └───┼───┘ ┌───┐ ╵ └─┐ ├───┤ └─┐ └───┐ ┌─┘ ┌─┬─┘ ├───┤ ╵ ╶─┴─┐ ╵ │ ┌─┤ ╶─┘ │ ╶─┤ ├─┘ ┌─┐ ╵ ┌─┴─┬─╴ │ │ ┌───┴─────┴─────╴ │ ╶─┴───┬───┴───────┤ ┌─╴ └───┤ ├───┘ ╷ ╵ │ │ ╵ ╷ │
│ │ └─┘ │ ┌─╴ ╵ │ ╶─┬─┘ │ ╷ ┌─┘ ╷ ┌─┘ ╶─┴───╴ │ ╵ ╷ └─╴ ├───┐ └─┘ ┌─┘ │ ┌─┘ ╷ └─────┐ └───┤ │ ╵ ┌───┘ ┌─┘ │ ╶─┤ └───┘ ╷ │ ┌─┘ │ │ ┌─┬─────────╴ ┌─┴─┬───┐ │ ╶─┬─────┐ │ └─────┐ ╵ │ ╶─┐ ├───┤ │ ┌─┘ │
│ ├─────┤ └───┐ ├─┐ └─┐ ╵ ├─┘ ┌─┤ │ ╶─┬───────┼───┴─────┤ ╷ └───┬─┤ ╷ ╵ ├─╴ ├─────┐ └─┬─╴ │ │ ┌─┘ ┌───┤ ╶─┴─┐ └─╴ ┌───┤ │ │ ╶─┘ │ │ ╵ ┌─────┐ ┌─┘ ╷ │ ╷ ╵ └─┐ ╵ ┌─╴ │ ├───┐ ╷ └─┬─┴─╴ │ │ ╷ ╵ │ │ ╶─┤
│ │ ╷ ╶─┤ ┌─╴ │ ╵ └─┐ └───┘ ┌─┘ │ └─┐ ╵ ┌─┬─╴ │ ╷ ┌─┐ ┌─┘ ├─┐ ╷ ╵ │ ├───┘ ┌─┘ ┌─╴ ├─┐ └───┤ └─┘ ╶─┤ ╷ ├───┐ └─────┘ ╷ │ └─┼───┬─┘ │ ╶─┤ ╶─┐ └─┘ ┌─┤ ├─┴─────┴─┬─┘ ┌─┘ │ ╷ │ └─┐ └─┐ ╶─┴─┘ ├───┼─┴─╴ │
│ │ └─┐ ╵ │ ╶─┴─────┴───────┴─╴ ├─┐ └─┬─┘ │ ╶─┤ │ │ │ │ ┌─┘ │ └───┤ └─╴ ┌─┘ ╶─┤ ╷ ╵ └─┬─┐ └───────┘ │ │ ╷ └───┐ ╶─┐ └─┴─┐ │ ╷ ╵ ┌─┴───┤ ╷ ├───┬─┘ ╵ │ ╶─────┐ │ ┌─┘ ┌─┘ │ └───┴─┐ │ ┌─────┘ ╷ │ ╶─┐ │
│ └───┴───┤ ╶───┬─╴ ╷ ┌─────┬─┐ ╵ └─┐ │ ╷ └─╴ └─┘ │ │ │ ╵ ╷ └─┬─╴ ├─────┘ ┌───┤ └─┬─┐ ╵ ├───────────┤ ╵ ├───┐ └───┤ ╷ ╶─┤ │ ├─╴ │ ┌─┐ └─┤ │ ╷ │ ┌───┴─────╴ │ │ └─┐ ╵ ┌─┴─────┐ ╵ │ │ ╶───┬─┤ ├─╴ │ │
├───┬───┐ ├───╴ │ ╶─┴─┘ ┌─╴ │ └───╴ │ │ ├─────┬───┘ │ └─┐ ├───┘ ╷ └───────┤ ╷ │ ╷ │ └─╴ │ ╶─────┐ ┌─┴───┘ ╷ └───┐ └─┴─┐ ╵ ╵ │ ┌─┘ │ └─┐ ╵ │ └─┤ └───┐ ╷ ┌───┤ │ ╷ └─┬─┘ ╷ ╶───┴───┤ │ ┌─╴ │ │ │ ┌─┘ │
├─╴ │ ╷ │ └─────┤ ╶─────┤ ╶─┤ ┌─────┤ └─┤ ╶─┐ │ ╷ ┌─┴─╴ │ │ ╶─┬─┴───┬───╴ │ │ ├─┘ ├───┐ └─────┐ │ ╵ ╶───┐ ├─┬─╴ ├───┐ └─┬───┤ │ ┌─┘ ╶─┴───┤ ╷ └─┬─╴ │ ├─┘ ╷ │ └─┴─┐ │ ┌─┴─────╴ ╷ │ └─┘ ┌─┘ │ │ └───┤
│ ┌─┘ │ └─────┐ ├───┬─╴ ├─┐ │ └───┐ └─┐ └─┐ │ │ └─┤ ╶───┤ ├─╴ │ ╷ ┌─┘ ┌───┘ │ ╵ ┌─┘ ╷ └─┬─┬─╴ │ ├─┬─────┤ │ │ ┌─┘ ╷ └─┐ └─┐ ╵ │ └───┬───╴ │ └─┐ │ ┌─┘ ╵ ┌─┘ ├─┬─╴ │ │ │ ┌───────┴─┴───┬─┘ ╷ │ ├───┐ │
│ ╵ ┌─┘ ┌───╴ │ │ ╶─┘ ┌─┘ │ └─┬─╴ └─╴ └─┐ ╵ │ └─┐ ╵ ┌───┘ │ ╶─┴─┤ │ ┌─┘ ╷ ╶─┴───┘ ┌─┴─┐ │ ╵ ┌─┤ │ │ ┌─╴ ╵ │ │ └─┐ └───┴─┐ └───┤ ┌─╴ │ ╶───┼─╴ │ │ └─┐ ╶─┤ ╶─┤ ╵ ┌─┘ │ │ ╵ ╶─┬───┬───┐ │ ╶─┤ ╵ │ ╷ ╵ │
│ ┌─┤ ┌─┴───┐ │ └─┐ ╶─┤ ╶─┴─┐ └─────┬───┴─┐ └─┐ ├───┘ ┌─┬─┴───╴ │ │ └─┐ └─┬─────┬─┘ ╷ ╵ │ ╶─┤ │ │ │ └───┬─┘ └─╴ └───┐ ╷ └───┐ └─┘ ┌─┘ ╶─┐ │ ┌─┘ └─┐ └─┐ └─┐ │ ┌─┴─┐ └─┴─┬─╴ ╵ ╷ └─╴ │ ├─╴ ├───┘ └─┐ │
│ │ │ ╵ ┌─┐ ├─┴─╴ ├─┐ └─╴ ╷ ├─────┐ │ ╶─┐ └───┤ ╵ ╶─┬─┘ │ ┌─────┘ ├─┐ ├─╴ ╵ ╷ ┌─┘ ┌─┴───┴─┐ │ │ ╵ ├───┐ │ ┌───┬───╴ └─┘ ┌───┼─────┤ ╶─┬─┘ │ │ ┌─┐ ├─┐ └───┘ │ ╵ ╷ └─┐ ╷ └─┬───┤ ┌───┘ │ ┌─┴─────┐ └─┤
│ ╵ └───┤ │ ╵ ┌───┘ └─────┤ │ ╶─┐ ╵ └─┐ ├───┐ └─┬─╴ │ ╷ │ │ ╶─┐ ╷ ╵ │ │ ┌───┴─┤ ┌─┘ ╷ ╶───┘ │ └─╴ │ ╷ │ └─┘ ╷ ├───┬─┐ ┌─┘ ╷ ╵ ┌─┐ └─╴ │ ╶─┘ │ │ │ ╵ ├───────┴───┴─┐ └─┤ ╷ ╵ ╷ │ │ ┌─╴ │ │ ╷ ╶─┐ └─╴ │
├─────┐ │ └───┘ ╶───┐ ╶───┘ ├─╴ ├───┐ │ └─┐ └─┐ │ ╶─┘ ├─┘ ├─┐ │ └─┐ │ ├─┘ ┌─┐ │ └─┐ └─────┬─┴─┐ ╶─┴─┘ └─┬───┤ ╵ ╷ │ ╵ │ ╶─┼───┘ └─┬───┼───┬─┘ │ ├─╴ │ ┌─────────┐ └─╴ ├─┴───┘ │ │ ├───┤ │ └─┐ └───┐ │
│ ╶─┐ │ └─┬───────┐ └───────┤ ╶─┘ ╷ │ └─┐ │ ╷ │ │ ┌───┘ ┌─┘ ╵ ├─╴ │ │ ╵ ┌─┘ │ └─╴ ├─┬───╴ │ ╷ ├───┬─────┘ ╷ └───┤ │ ┌─┴─╴ │ ┌───┐ ╵ ╷ └─╴ │ ┌─┘ ╵ ╶─┤ ├───┐ ┌───┴─┬───┘ ┌─┬───┘ │ ╵ ╷ │ └─┐ ├───┐ └─┤
├─╴ │ └─┐ │ ╶─┬─┐ │ ┌─────┬─┴─────┤ └───┤ └─┤ │ └─┤ ┌───┼─────┘ ┌─┘ ├───┴─╴ ├─────┘ │ ┌───┘ │ ╵ ╷ ╵ ┌─────┴───┐ ╵ ├─┘ ┌───┘ │ ╷ └─┬─┴─┐ ┌─┘ ├───────┤ ╵ ╷ │ │ ┌─┐ ╵ ╷ ╶─┤ ╵ ┌───┤ ┌─┘ ├─┐ └─┤ ╷ └─╴ │
│ ╷ ├───┘ ├─╴ │ ╵ │ │ ┌─┐ ╵ ┌───┐ ├───┐ └─┐ │ └─╴ │ ╵ ╷ │ ╶─┬───┤ ╶─┘ ┌───┐ └─╴ ┌───┘ │ ╶─┬─┴───┴───┴─╴ ┌───┐ ├─╴ │ ╶─┤ ╶───┘ └─┐ ╵ ╷ └─┤ ╷ │ ╶───┐ └───┤ │ │ ╵ └─┬─┴─┐ └───┘ ╷ └─┤ ╷ ╵ └─┐ ╵ ├───╴ │
│ └─┤ ╶─┬─┘ ╶─┤ ┌─┴─┘ │ └───┴─╴ │ ╵ ╷ └─┐ │ └─┐ ╶─┼───┘ │ ╷ ╵ ╷ └─┬───┘ ╷ └─┬─╴ │ ┌─┬─┴─╴ │ ╶───┬─────┬─┤ ╶─┘ │ ┌─┴─┐ └─────────┼───┼─╴ │ │ ├───╴ │ ┌─╴ │ │ └───┐ │ ╷ └───────┴─┐ │ └───┐ └───┤ ┌───┤
│ ╷ └─┐ └─┐ ╷ │ ╵ ┌───┤ ╶─┐ ┌─╴ ├───┴─╴ │ └─┐ ├─┐ ╵ ┌───┘ └───┼─╴ │ ╶─┬─┤ ╷ │ ┌─┤ │ ╵ ╷ ╷ ├───┐ ╵ ╶─┐ │ │ ┌─┬─┘ │ ╷ └─────────┐ ╵ ╷ │ ╷ │ └─┘ ┌───┤ └───┘ │ ┌───┤ └─┴───────┐ ╷ │ │ ╶─┐ │ ┌───┤ │ ╷ │
│ │ ╶─┼─╴ │ │ │ ┌─┴─┐ └─┐ │ └─┬─┘ ┌─────┴─╴ │ │ └─╴ ├─────────┤ ┌─┴─┐ ╵ │ └─┘ │ │ │ ╶─┤ ├─┘ ╷ └─┬───┘ │ ╵ │ │ ╶─┤ ├─┐ ╶───────┴───┤ │ │ ├─────┴─┐ └───────┘ ╵ ╷ └─┐ ┌─────┐ └─┘ │ └─┐ │ └─┘ ╷ ╵ └─┘ │
│ └─┐ ╵ ┌─┤ │ └─┤ ╷ └─┐ │ └─┐ │ ┌─┘ ╷ ┌─┐ ┌─┘ ├─────┘ ┌───┐ ╷ │ ╵ ╷ ├─┐ ├───┬─┘ │ └─┐ │ ╵ ╶─┴─┐ │ ╶───┤ ╶─┘ └─┐ │ ╵ └─────────┬─╴ │ │ │ └─╴ ┌─┐ └─┐ ┌───┬─────┤ ╷ │ │ ╶─┐ ├─────┴─╴ ├─┴─┬───┴─────┐ │
├─┐ └─┬─┘ │ └─┐ ╵ ├─╴ │ ├─╴ │ ╵ │ ╶─┤ │ │ │ ╶─┤ ┌───┬─┘ ╷ └─┘ │ ┌─┘ │ ╵ │ ╷ │ ╷ └─┐ │ ├───────┘ ├───╴ ├───┐ ┌─┘ ├─────────┬─╴ │ ┌─┘ │ ├─────┤ ├─╴ │ └─╴ │ ╶─┐ │ │ ╵ ├─╴ │ ╵ ┌───┬─╴ │ ╷ ╵ ┌─────┐ │ │
│ └─┐ │ ╷ └─╴ ├───┤ ╶─┤ ╵ ┌─┴───┴───┘ │ │ ├─┐ ╵ │ ╷ │ ╶─┴─┐ ┌─┴─┤ ┌─┘ ╶─┘ │ ╵ │ ┌─┘ │ │ ┌───┬───┘ ┌─╴ │ ╷ └─┤ ┌─┴─╴ ╷ ┌───┤ ╶─┤ │ ┌─┘ ╵ ╶─┐ │ ╵ ┌─┴─────┼─╴ │ ├─┴───┤ ┌─┴───┘ ╶─┘ ┌─┤ └─┬─┘ ┌─╴ │ │ │
│ ╷ ╵ ├─┴───┬─┘ ╷ └─╴ │ ┌─┘ ╶─┐ ╶───┬─┘ │ ╵ └─┬─┘ │ └─┬─┐ └─┘ ╷ │ ├───────┴───┤ │ ╶─┤ │ │ ┌─┘ ╷ ┌─┴───┤ └─┐ │ └─┐ ┌─┴─┘ ╷ └─╴ │ │ ├───┬───┤ └─┐ ╵ ┌───┐ │ ╶─┤ ╵ ┌─┐ │ └─┐ ┌───────┘ └─┐ │ ┌─┘ ╷ │ └─┤
│ └───┤ ╶─┐ ╵ ┌─┴─────┤ └─────┴───┐ └─┐ └───┐ ├───┘ ╷ │ └─┬───┘ │ │ ┌─┬─────┐ │ ├─╴ │ │ │ │ ╶─┤ ╵ ┌─┐ └─┐ │ └─┐ │ │ ╶───┼─────┤ │ ╵ ╷ │ ╷ │ ╷ └─┬─┘ ╷ │ │ ╷ └─┬─┘ │ ├─╴ │ └─┐ ┌─╴ ╷ ┌─┘ ├─┘ ┌─┘ ├─╴ │
├─┬─╴ │ ╷ └─┬─┘ ╶─┐ ╶─┘ ┌─────┬─╴ │ ╷ └─┐ ╶─┤ ╵ ┌───┘ └─╴ │ ┌───┤ ╵ │ ╵ ┌─╴ │ └─┘ ┌─┴─┘ │ └─┐ └───┤ └─┐ ╵ ├─┐ ╵ │ └───┐ └───╴ │ └───┤ ╵ │ │ ├─╴ │ ╷ └─┘ │ ├─╴ ├─╴ │ │ ╶─┴─┐ └─┘ ┌─┤ │ ┌─┘ ┌─┤ ╶─┤ ╶─┤
│ │ ┌─┤ ├─┐ └─────┴─────┘ ╶─┐ │ ╶─┴─┤ ╷ └─┐ └─┬─┘ ┌─┬─────┘ │ ╶─┤ ╶─┤ ╶─┤ ╷ └─┬───┤ ╷ ┌─┘ ╶─┴─┬─╴ │ ╷ └───┤ └───┤ ╶─┐ └───┬─╴ ├───┐ └───┤ └─┤ ╶─┤ └─┬───┴─┤ ┌─┘ ╶─┘ ├───┐ └─┬─┬─┘ ╵ │ └─┐ │ ├─╴ ├─┐ │
│ │ │ ╵ ╵ └─┬───┐ ╶───┬─────┤ ├───┐ └─┴─╴ │ ╶─┘ ╶─┘ │ ┌───┬─┘ ╷ └─┐ └─┐ │ └─┐ ╵ ╷ └─┤ └─┬─╴ ╷ │ ╶─┤ └─┬─╴ ├─╴ ╷ └─┐ └───┐ ╵ ┌─┘ ╷ ├───┐ └─┐ │ ╷ └─┐ ╵ ┌─╴ │ │ ┌─────┘ ╷ ├─╴ │ ╵ ┌───┴─┐ │ │ ╵ ╶─┘ │ │
│ │ └─┬─╴ ┌─┘ ╷ ├─────┤ ┌─╴ │ │ ╷ └─────┬─┤ ┌───┬───┘ │ ╷ ╵ ╶─┼─┐ └─┐ │ └─┐ ├─┬─┴─┐ ├─╴ │ ╶─┴─┴─╴ │ ╷ └─┐ │ ╶─┼─┐ └─────┴─┐ ╵ ┌─┘ │ ╷ ╵ ╷ │ └─┤ ╷ └───┤ ╶─┘ │ ╵ ┌───┬─┘ │ ┌─┴───┘ ╷ ╷ │ │ └─┬─────┘ │
│ └─┐ └─┬─┘ ┌─┤ ╵ ┌─╴ │ │ ┌─┘ │ └─┬───┐ │ │ ├─╴ │ ┌───┘ ├───┐ ╵ │ ╶─┘ └───┘ │ ╵ ╷ │ ╵ ┌─┴─────┐ ┌─┴─┴─╴ │ │ ╷ │ ├───────┐ └───┴───┤ └───┴─┴─┐ └─┴─┐ ╷ │ ┌───┼─┬─┘ ╶─┘ ┌─┘ ╵ ┌───┐ │ ├─┘ ├─╴ │ ╶───┐ │
│ ╶─┼─╴ ╵ ┌─┘ └───┘ ╶─┘ │ ╵ ╷ ├─╴ │ ╷ ╵ │ ╵ │ ┌─┘ │ ┌───┤ ╷ ├─╴ └───┬───────┴───┤ └─╴ │ ┌───╴ │ ╵ ┌───┬─┘ ├─┘ │ │ ╶─┬─┐ │ ┌───┬─╴ │ ╶─────┐ └───┐ └─┤ └─┘ ╷ │2│ ╶─┬─┬─┘ ┌───┘ ╷ │ │ ╵ ┌─┘ ╷ └───┐ │ │
│ ╷ ╵ ┌─┬─┴─────────┐ ┌─┴─┐ ├─┘ ┌─┤ └───┤ ╶─┤ │ ┌─┤ └─╴ │ │ └───────┘ ┌───────┐ ├─────┘ │ ╶─┬─┴───┤ ╶─┘ ╶─┘ ┌─┘ └─╴ │ │ ╵ │ ╷ └─┐ └───┐ ┌─┴─┐ ╷ └─┐ └─┬───┘ │ ├─╴ │ ╵ ┌─┘ ┌───┤ └─┤ ┌─┘ ╷ └───┐ │ └─┤
│ └───┘ │ ┌─┬─────╴ └─┘ ╷ └─┘ ┌─┘ └─┬─╴ ├─┐ ╵ │ │ ╵ ┌───┘ ├─────┬─────┴─────╴ │ ╵ ┌─────┴─╴ │ ╶─┐ ╵ ╶─┬───┬─┤ ╶─┬───┘ ├───┤ └─┐ └───┐ └─┘ ╷ │ ├─┐ └─┐ ╵ ┌─┬─┘ ╵ ┌─┴───┘ ┌─┘ ╶─┼─╴ │ └───┴───╴ │ └─┐ │
├───┬───┘ │ │ ┌───┬───┐ ├─────┴─┐ ╶─┘ ┌─┘ ╵ ┌─┘ │ ╶─┤ ┌───┘ ╷ ╶─┘ ╷ ┌─╴ ┌─────┴───┘ ┌───┬─╴ ├───┤ ┌───┘ ╷ │ └─╴ ╵ ┌─╴ ╵ ╷ └─┐ ├───┐ └─┬───┤ ╵ │ └─┐ └─┬─┘ │ ╶───┤ ╶─────┤ ╶─┐ │ ╶─┴─────┬─────┼─╴ │ │
│ ╷ ╵ ┌───┘ ╵ │ ╷ ╵ ╷ │ │ ╶───┐ └───┐ │ ┌───┘ ┌─┼─╴ │ │ ╶─┬─┴───┐ │ │ ╶─┤ ╶───────┐ │ ╷ └─┐ │ ╷ └─┘ ┌───┘ ├───┬───┴─────┴─┐ │ ╵ ╷ ├─┐ └─┐ └───┘ ╷ └─╴ ╵ ┌─┴─┬─╴ ├─────┐ └─┐ │ └─┬───┬─╴ │ ╷ ╶─┘ ╶─┤ │
│ └─┬─┴───┐ ╶─┤ ├───┤ ├─┴───┐ ├───┐ │ └─┘ ┌───┘ ╵ ╶─┤ └───┤ ┌─╴ ├─┘ ├─┐ └───────┐ └─┤ ├─┐ └─┘ ├─────┤ ╶─┐ │ ╷ ╵ ┌───────┐ └─┼───┘ │ └─┐ │ ╶─┬───┴───┐ ┌─┘ ╷ ╵ ┌─┘ ┌─╴ ├─╴ │ ├─┐ ╵ ╷ ╵ ┌─┘ └─┬───┐ │ │
│ ╷ ╵ ╶─┐ └───┘ └─╴ │ ╵ ╶─┐ ╵ ╵ ╷ │ └─────┴─────────┴───╴ ╵ │ ╶─┘ ┌─┘ └───────╴ └─┐ ╵ ╵ └─────┘ ┌─╴ └─┐ └─┘ └───┴─╴ ┌─╴ └─┐ ╵ ╶───┘ ╷ │ └───┘ ╶───┐ └─┘ ╶─┴───┘ ┌─┘ ╶─┘ ┌─┘ ╵ └───┴───┴─────┘ ╷ └─┘ │
└─┴─────┴───────────┴─────┴─────┴─┴─────────────────────────┴─────┴───────────────┴─────────────┴─────┴─────────────┴─────┴─────────┴─┴───────────┴─────────────┴───────┴─────────────────────┴─────┘
